tab=\t
return=\r
newline=\n
:barA	A̅
:bara	a̅
:barB	B̅
:barb	b̅
:barC	C̅
:barc	c̅
:barD	D̅
:bard	d̅
:barE	E̅
:bare	e̅
:barF	F̅
:barf	f̅
:barG	G̅
:barg	g̅
:barH	H̅
:barh	h̅
:barI	I̅
:bari	i̅
:barJ	J̅
:barj	j̅
:barK	K̅
:bark	k̅
:barL	L̅
:barl	l̅
:barM	M̅
:barm	m̅
:barN	N̅
:barn	n̅
:barO	O̅
:baro	o̅
:barP	P̅
:barp	p̅
:barQ	Q̅
:barq	q̅
:barR	R̅
:barr	r̅
:barS	S̅
:bars	s̅
:barT	T̅
:bart	t̅
:barU	U̅
:baru	u̅
:barV	V̅
:barv	v̅
:barW	W̅
:barw	w̅
:barX	X̅
:barx	x̅
:barY	Y̅
:bary	y̅
:barZ	Z̅
:barz	z̅
